-20
22
-8
12
0000000000000000000000000000000000000000000
0000000000000000000000000000000000000000000
1111111111111111111111111111111111111111110
1000000000000000000000000000000000100000010
1000000000000000000000000000000000100000010
1000000011111100000000000000000000100000010
1000000011111100000000000000000000100000010
1000000011111100000000000000000001110000010
1000000000000000011111110000000001110000010
1000000000000000111111110000000000100000010
1000000000000000111101111000000000100000010
1000000011111100000000000000000000100000010
1000000011111100000000000000000000100000010
1000000011111100000000000000000001110000010
1000000000000000000000000000000001110000010
1000000000000000000000000000000000100000010
1000000000000000000000000000000000100000010
1000000011111100000000000000000000100000010
1000000011111100000000000000000000100000010
1000000011111100000000000000000001110000010
1111111111111111111111111111111111111111110
